10010437
00042483
00440913
00249993
012989b3
00000a13
01390a63
00092a83
015a0a33
00490913
ff1ff06f
10010b37
024b0b13
014b2023
00008067
